1111111111111111
1P0000100000C001
1000011000110001
1C001000001000C1
1000100C10100001
100000001010C001
1C0011100010C001
1001000000100001
1000100000011001
1C00000000000CE1
1111111111111111
