11111
1P001
10C01
10C01
11E11
