11111111111111111111
10110000000000001001
10001110110C00001011
1E001110100000111101
100010101000T0101001
10000P1000M001101001
11011010110110111001
100M111010C10T001M01
1000001T1111000000T1
1000CC0000C000000001
10100000100000000001
11111111111111111111
