11111111111
1P000T00001
10000000001
100MM0000C1
10000000001
1000T0000E1
11111111111
