11111111111111111111111111111111111111111111111111
100000000000010000010110010000000010T0000000000001
10000M000000000011000C0000100100000001000000000001
1000C100000001001000000010000000000000000001000001
10000000000000000000000000000000101000110000100001
10000000000010010100000PC0100000000111111100T10001
10000100000000000000000000000000010010001000000001
10000000000000000000000100000010110010001000000001
10C0000001100100000100000000C000000011001000000001
10010000100000000000000000010010000010001000000001
1000M011100000CC0000011000000000000011111000010101
10101001010100010000000000001000001000000000000001
10011001010010000000110000000000000000000000000001
11000001010T00000000000000000011111101000000000001
10000001110000000C00000000011110000100000100000001
1000000C100000000000000C01C00010000100000000010001
10000000000000000000000000000010000100000000000101
10100010000C00000000000000000010100100000000000001
10000000010000000000000000000011101100000001000001
100000T0000000100000001000100000000000000100000001
10010000000001000000010000000000000100000110000101
100000100000000001001000001000000000100000100C0001
10000000000000000000100111100100000000000100000001
100000000000110000000100101C001000000010001E000011
1C00000011000000000000C010100000000000010100000101
100000000000000010000000101000000000000011T0000001
10010000000000000000000111100000100010000000000001
100000000C100000100C000000000010000010000001010001
100000010000000000C00000000000000000001C1000000001
11111111111111111111111111111111111111111111111111
