111111111111111111111111
1P000100000000C00000C011
100001100001100000110001
1C00100000010000010000C1
1000100C1010000001000001
10000000100100C000100001
1C001110001000000010C001
100100000010000000010001
100010000001100000001101
1C00000000000000000000C1
100001111110000111110001
10000C000000000000000C01
100100011110000111100001
100000000000000000000001
1C0000C00000000000C00EC1
111111111111111111111111
