11111111111111111111
1P000000000000000001
100000000000000000C1
1000000000000000C001
100000000000000000C1
100000M00M0000000001
100000000000000000C1
100000000000000000C1
100000T00T0000000001
100000000000000000C1
100000000000000000C1
100000M00M0000000001
100000000000000000C1
100000000000000000C1
10000T00T00000000E01
11111111111111111111
