1111111111111111111111111111111111111111
10000000000000001T000M0M0100000001000001
10100P000C000000000000000000010000000001
1100000000000001110010000000000001001001
1000000000000101010001111111010000000001
1000001111111101110001000001000100000001
10000010000001000000010000010000100C0001
1000001000100101110001111111000000000001
1000001000100100000000000000010001100101
1000001011000100000000001101100000000001
100000111111110000000001100C100000001001
1000000000000001100000001001100000000001
1010001000100000000000101111100000010011
1000000000100000100000000000000001000001
1010000011010000000000000010000001000001
1100000000000M10000001000000100000000001
101000000100001010000000000000C000110001
100010C00000000000000000C000001000000011
1101010000C00000000010001010T10100010001
1000000000000000000000000000000000000001
1000000000000000110100000C10000000000101
1000000000C000000100100000E0000001000001
10000000001100T0000101010000000000000001
1000000C00000000100001000000000000000001
1111111111111111111111111111111111111111
