1111111111111111111111111
100000000000000001C00C001
1000C00CP0000111111000001
1010111111000100001000101
10001000010101000010CC001
10101000010T0111111000101
10001111110100000000E0001
1000000000000000010000101
1000000001M000001010000C1
1000100000000000000110001
11100001000T0001000000101
1111111111111111111111111
