11111111111111111111
1000010M000000000001
10010010000000000101
10001000000000000001
100000000000000000C1
1100P101101001000001
10001100100000000001
10C011111000001C1001
10111111100100000001
10110001000000000001
101011110E10T000CM01
10C0000000C000010001
100000000000100T0001
11C01C00000001000001
11111111111111111111
