11111111111111111111
10000000000M00000001
1000000000000000C001
100P0000000111110001
10000000000100M10001
100000000001000100T1
10000001011111010001
10000001C001T0000001
10000001000100000E01
10000001111100000001
1000000000T000000001
100000C000000C000001
100000C0000000000001
11111111111111111111
