111111111111111
100000P000M0001
11000000010T001
10000000C111011
1100001001T1001
100011110111001
1T1CE0110010011
100011110M00C01
100000100000001
111111111111111
