111111111111111111
100C00000000000001
1T0000000000000001
100000000000000001
10M0000000000000T1
1000P0000C00000001
100000000000000001
100000000000000001
1000C0000000000001
1000000000000E0001
100000000000000001
111111111111111111
