1111111111111111111111111111
10C000T00000000C00C00C00C001
10000C00000T000C000CC0TT00T1
1C00C000C00T00M01111111100T1
100M000P000000001100T1010001
1C00000C00CC0C00111111110T01
1000C0000C00CC0CC00M0100C001
1C00C0CC00T0001110111100CC01
10000000CC000010C10C0M000001
1000000011111110C10C0TTMM001
1000CC0T10000C00000000000001
1MT000M011111100C0000000M001
100C0M00E00CC0CC0MM0M00T00C1
1000C0000M000000000C00M0C001
1111111111111111111111111111
