11111111
100C0EC1
10P00101
1T0001C1
10000M01
10010001
10CC0001
11111111
