1111111111111111111111111111111111111111
101000000000000000M000000000000100010001
1000000000000000000110C0C00C110010000001
100000110C0C000M010000000100000000100001
10000000101000000010C0000000111110T00001
10T0000010000000000000000000100010000001
1M0010000P0000001C0000000111111111000011
10010010010T0001010E00C00110101011TC0001
1000000001000000000000000111111111111101
1010000000000000000000000011111111001111
10000C00T0000000011010100000001111011101
100010000000100T0T0010000000000000000001
10CC00010000001000000T000000101001000001
1000001000000000100000000M01000010001001
100000001010000C10000000010M010010000001
100000000000000000T000000000000000010011
10000000000000000000000000000001C0000011
100C00100000CT0000C00C000100010001C01001
100000000100000000001000001000000C100001
1111111111111111111111111111111111111111
