111111111111111111111111111111
1000001001M00C00000T00010000C1
1000T0111111M00000000T01010001
100000100101000001000000010001
111C0010000100000001M1TM000001
100100100011111011001101111101
1000000C00000000000110000E1101
1000C0P000010000100010CM10M101
1TT0000C1011111110101100000101
10000T000M000000T0001111111101
100000010010M00100000000000011
1000000T0000T00010100000101001
1C0010100000000001111111111001
1000000T0000100001000000100001
10C0M1001000000001111111100001
110M00000000010001000T01000001
111111111111111111111111111111
