111111111111111111111111111111
1T0TT0000CC00000CC00T0C0000001
1T0T00C0C0001111111000000C00T1
10T0C00T0C0010C00010T0C0T00TT1
1C00C00001000T00CCC00C0TTT0001
10TT0000T0C00T000000000T000001
1C0T00T00101T00T100C0001C0TT01
10C00T0C0P0111C0100000C1000T01
1000T0C00111T1C01T0C00010T00T1
1C0C0000T001010011111111TT00T1
100C0C0C00C1010T0C00CCC000CC01
1C0C000CCC011100T0C00000000CC1
10C0000C000T00CC0T0T0C00C00C01
100T0C00T000C000000TT00C000CC1
10000C000000000000T00T0000C001
1T00T000CC0CC000CE0CC0CC0000C1
111111111111111111111111111111
