1111111111
1P0C0E0001
1000011001
1C00E00001
1111111111
