1111111111
1P00000001
1000011001
100E000001
1111111111
