1111111111
1P0C000001
1000011001
1C0000001
1111111111
