1111111111
100C000001
1000011001
1C00E00001
1111111111
