1111111111
1P0C000001
1000011111
100001E001
1111111111
