1111111111
1P00000001
1111111001
1C00E00001
1111111111
